3,1,1,1,1,5,1,1,3,1,3,1,1,1,3,1,1,1,3,0,
1,4,1,2,4,1,1,7,1,1,1,1,2,1,1,3,1,2,1,0,
1,1,1,6,1,1,2,1,3,1,2,7,1,1,2,1,6,3,1,0,
1,7,2,1,3,1,1,1,1,1,1,1,1,3,3,1,1,3,7,0,
3,1,1,1,1,1,7,5,1,1,3,1,2,1,1,1,2,1,1,0,
1,1,3,1,3,1,3,6,1,3,1,1,1,1,3,1,7,5,3,0,
1,7,2,1,1,1,6,3,1,1,4,1,7,1,1,1,2,6,1,0,
1,1,1,3,1,1,1,1,1,1,1,1,4,1,2,1,4,3,1,0,
1,4,1,7,1,2,1,7,5,1,1,1,1,1,1,1,3,1,1,0,
3,7,1,1,1,1,1,2,1,7,1,1,1,1,7,3,1,2,2,0,
1,1,1,2,1,3,1,1,1,1,2,1,1,1,1,2,1,7,1,0,
1,2,1,1,1,1,4,1,1,5,3,1,2,1,3,1,1,6,5,0

